Serratil anterior = abdução das escapulas
Reto abdominal = flexão de tronco
Fibulares (curto e longo) = flexão plantar e eversão do pé
Peitoral maior = adução, extensão e rotação do ombro
Peitoral menor = elevação das costelas
Extensão longo do halux = extensão do halux, flexão dorsal e inversão do pé
Semitendíneo = extensão do quadril e rotação do joelho
 Semimembraneceo = extensão do quadril e flexão do joelho
Subescapular = adução do braço 
Iliopsoas = flexão do quadril e flexão da lombar
Redondo maior = adução do ombro
Tríceps braquial = extensão do cotovelo
Supraespinhal = abdução do braço 
Bíceps braquial = flexão do cotovelo e flexão do ombro
Infraespinhal = rotação lateral do braço 
Latíssimo do dorso = adução e extensão do braço
Braquial = flexão do cotovelo
Trapézio = adução das escapulas e elevação do ombro
Glúteo máximo = extensão do quadril
Glúteo médio = abdução e rotação da coxa
Glúteo mínimo = abdução e rotação da coxa
Tensor da fáscia lata = flexão do quadril e rotação do joelho
Bíceps femoral (cabeça longa e curta) = extensão e flexão do quadril e rotação do joelho
Soleo = flexão plantar do tornozelo
Fibular terceiro = extensor dos dedos 5 e aversão do pé 
Flexor longo dos dedos = flexão plantar e inversão do tornozelo
Flexor longo do hálux = flexão do hálux, flexão plantar e inversão do pé 
Quadríceps femoral = flexão do quadril e extensão do joelho
Gastrocnêmios = flexão do joelho e flexão plantar do tornozelo
Adutor longo = adução da coxa
Adutor curto = adução da coxa 
Grácil = adução da coxa e flexão do quadril
Pectíneo = adução da coxa e flexão do joelho
Tibial posterior = flexão plantar e inversão do pé
Sartório = flexão do quadril 
Obliquo interno = rotação do tronco
Extensor dos dedos = extensão do 2 ao 5 dedo
Tibial anterior = flexão dorsal e inversão do pé
Adutor magno = adução da coxa
Peitoral maior = adução do ombro
Deltoide = abdução do braço
Romboide = adução das escapulas e elevação do ombro
Coracobraquial = adução e flexão do ombro
Redondo menor = adução e rotação do ombro
Reto femoral = flexão do quadril
Bíceps femoral = extensão do quadril